------------------------------------------------------------------------------------------------------------------------------------------------------------------------------------------------------
------------------------------------------------------------------------------------------------------------------------------------------------------------------------------------------------------
------------------------------------------------------------------------------------------------------------------------------------------------------------------------------------------------------
------------------------------------------------------------------------------------------------------------------------------------------------------------------------------------------------------
----------------------------------------------------------------------------------------------------------------------------------------------------------------------------------------xx------------
----------------------------------------------------------------------------------------xx--------------------------------------------------------------------------------------------xx-xx-----------
-------------------------------------------------------------------------------------SUSx-x-----------------------------------------------------------------------------------------x-x-##x-----------
------------------------------------------------xx-----------------------------------xxx---x----------------x----------------------------------------------xx----------xx-------x--xx-x-##x-----------
------------------------------------------------x-x---------------------------------xxxx---x---------------x-x-----------------------------------------TT-xxx---------xxxx----xxxxxxxxx-##x-----------
-----------------------x---------xx----x--------x-x------x-------xx-----------xx---xxxxxx---x--------x---xx---x---xx---------------------xx--xxxxxx-x--TT-x--x--------x--x----x--Kx-x#--##x------xx---
---xxxxxx----xx-------x-xx------xxxx--xxxx--xxxx--x----xx-xx--xxxx-x----xxx--xxxx--x#####---x-xxxx--xxx-xxx----xxxxxx-----xxx-----------x-xx-x#LSSxxxxx##xx--x-----xxx---x---xx---x-##--##x-----xx----
--x--xx-xx---x-x-----x---x------x--x--xTTx-x--TT--x-K--x---x--xxx---x---x-x--x--x--x#-------x-x--xx-x--xxxxx---#xx--x-xx--x--x---------x---x-x#xx-x---x--xx--xxxx--xxx---x--x-----x###--##x----x------
--x--xx--x---x-x-----x----x----x----x-xTTx-x--TT--x---x----xxx--x----x-x--x--x--x--K#-------x-x---x-x--xx-*----#x---xx-x-x----x--------x----xx#xxxx---x--x*---TTxx-x-*----x-x-----####----x----x--F---
-Mx--xx--xkxx-gggxxxx----gggxxxx----xkkTTxxx--TT---xxxx----ggg--x----ggg--xxx----xxx#-------xx----xggg-xx-*----#x---gggxxk----gggxxxxxxx----kk#xxxx---xxxx*---TT-xx--*----xKx----#####----xxxxx---#---
XXXXXXXXXXXXXXXXXXXXXXXXXXXXXXXXXXXXXXXXXXXX--XXXXXXXXXXXXXXXXXXXXXXXXXXXXXXXXXXXXXXXXX----XXXXXXXXXXXXXXXXXX--XXXXXXXXXXXXXXXXXXXXXXXXXXXXXXXXXXXX---XXXXXXXXXXXXXXXXXXXXXXXXXXXXXXXXXXXXXXXXXXXXXXXX
XXXXXXXXXXXXXXXXXXXXXXXXXXXXXXXXXXXXXXXXXXXX--XXXXXXXXXXXXXXXXXXXXXXXXXXXXXXXXXXXXXXXXX----XXXXXXXXXXXXXXXXXX--XXXXXXXXXXXXXXXXXXXXXXXXXXXXXXXXXXXX---XXXXXXXXXXXXXXXXXXXXXXXXXXXXXXXXXXXXXXXXXXXXXXXX