-----------------------------------------------------------------------------
-----------------------------------------------------------------------------
-----------------------------------------------------------------------------
-----------------------------------------------------------------------------
-----------------------------------------------------------------------------
-----------------------------------------------------------------------------
---------------------------------------------------------------##------------
--------------------------------------------------------------###------------
-------------------------------------------------------------####------------
------------------------------------------------------------#####------------
------------#--#----------##--#------------SS!S------------######------------
-----------##--##--------###--##--------------------------#######------------
----------###--###------####--###-----tt--------------tt-########--------F---
---M-----####--####----#####--####----tt---------gg---tt#########--------#---
XXXXXXXXXXXXXXXXXXXXXXXXXXXX--XXXXXXXXXXXXXXXXXXXXXXXXXXXXXXXXXXXXXXXXXXXXXXX
XXXXXXXXXXXXXXXXXXXXXXXXXXXX--XXXXXXXXXXXXXXXXXXXXXXXXXXXXXXXXXXXXXXXXXXXXXXX