------------------------------------------------------------------------------------------------------------------------------------
------------------------------------------------------------------------------------------------------------------------------------
------------------------------------------------------------------------------------------------------------------------------------
------------------------------------------------------------------------------------------------------------------------------------
------------------------------------------------------------------------------------------------------------------------------------
----------------------------------------------------------------------------------------------------------------------!-!-----------
------------------------------------------------------------------------------------------------------------------------------------
---------------------------------------------------------------------------------------------------------------------!---!----------
-----------------------------------SS---------------------------------------------------------------------------------!!!-----------
--------------------------------------------------------g-------------------------------------------------00------------------------
--------------------------------------------------------SSSS SS----------#----------------------------------------------------------
-------------------------------tt---------------------------------------##----------------------------------------------------------
-----------tt------------------tt-------tt-----------------------------###------------------------------------------------------F---
---M-------tt------g-g---------tt----g--tt-----------------------g-g--####-----k-----------------g-g---------k------gg-g-g------#---
XXXXXXXXXXXXXXXXXXXXXXXXX--XXXXXXXXXXXXXXXXXXXX--XXXXXXXXXXXXXXXXXXXXXXXXXXXXXXXXXXXX--XXXX--XXXXXXXXXXXXXXXXXXXXXXXXXXXXXXXXXXXXXXX
XXXXXXXXXXXXXXXXXXXXXXXXX--XXXXXXXXXXXXXXXXXXXX--XXXXXXXXXXXXXXXXXXXXXXXXXXXXXXXXXXXX--XXXX--XXXXXXXXXXXXXXXXXXXXXXXXXXXXXXXXXXXXXXX