-------------------------------------------------------------------------------------------
-------------------------------------------------------------------------------------------
-------------------------------------------------------------------------------------------
-------------------------------------------------------------------------------------------
-------------------------------------------------------------------------------------------
-----------------------g-------------------------------------------------------------------
---------------------SSSSSSSS---SSS!--------------@-----------SSS----S!!S------------------
-------------------------------------------------------------------------------------------
--------------------g----------------------------------------------------------------------
-----1-------------------------------------------------------------------------------------
------------------S@S--------------C-----SU----!--!--!-----S----------SS-------------------
-------------------------------------------------------------------------------------------
---------------------------------------------------------------------------------------F---
---M--------------------------------g-g--------k-----------------gg-g-g----------------#---
XXXXXXXXXX--XXXXXXXXXXXXXXX---XXXXXXXXXXXXXXXXXXXXXXXXXXXXXXXXXXXXXXXXXXXXXXXXXXXXXXXXXXXXX
XXXXXXXXXX--XXXXXXXXXXXXXXX---XXXXXXXXXXXXXXXXXXXXXXXXXXXXXXXXXXXXXXXXXXXXXXXXXXXXXXXXXXXXX