-----------------------------------------------------------------------------
-----------------------------------------------------------------------------
-----------------------------------------------------------------------------
---------------------------------------------------------------x-------------
-------------------------------------------------------------xxx-------------
-------------xx---------------------------------------------xxxxxx-----------
------------xxx-------------xx------------------------------x-x##x-----------
------------x-xx-----------x-xx---------------------------x-x-###-x----------
------------x--x---------xxx--x--------------------------x-xx####-x----------
--------xxxxx--xx------xxxxx--x----------------------x--x---#####--x---------
-------xxxxx#--#xx----xxxx##--#x-----xx----SS!S-----xxx-x--######--x-----x---
-------x--x##--##x----x--###--##xx--x--x-----xxxx---x--xx-#######--x----x----
-------x--###--###x--x--####--###xx-x-ttx----xxxxx-x--tt-########--x----xF---
---Mxxx--####--####xxx-#####--####xxx-ttxxxxxxx-xggx--tt#########---xxxx-#---
XXXXXXXXXXXXXXXXXXXXXXXXXXXX--XXXXXXXXXXXXXXXXXXXXXXXXXXXXXXXXXXXXXXXXXXXXXXX
XXXXXXXXXXXXXXXXXXXXXXXXXXXX--XXXXXXXXXXXXXXXXXXXXXXXXXXXXXXXXXXXXXXXXXXXXXXX