-------------------------------------------------------------------------------------------
-------------------------------------------------------------------------------------------
-------------------------------------------------------------------------------------------
-------------------------------------------------------------------------------------------
-------------------------------------------------------------------------------------------
-----------------------g-------------------------------------------------------------------
---------------------SSSSSSSS---SSS!--------------@-----------SSS----S!!S------------------
-------------------------------------------------------------------------------------------
--------------------g----------------------------------------------------------------------
-----1--------x-------------x--------------------------------------------------------------
----------xxx-xx--S@S------x-x---x-C-----SU----!--!--!-----S--xx------SS--------------xx---
----------x-x-xxx---------x--xx-xxx--------xx-----------------xxx--------------------x-----
---------x---xxxxx--------x---x-xxx--------xxx---------------xxxx--------------------x-F---
---Mxxxxxx---xxxxxxxxxxxxxx---xxxxxxgxgxxxxxxxxkxxxxxxxxxxxxxxxx-ggxgxgxxxxxxxxxxxxxxx-#---
XXXXXXXXXX--XXXXXXXXXXXXXXX---XXXXXXXXXXXXXXXXXXXXXXXXXXXXXXXXXXXXXXXXXXXXXXXXXXXXXXXXXXXXX
XXXXXXXXXX--XXXXXXXXXXXXXXX---XXXXXXXXXXXXXXXXXXXXXXXXXXXXXXXXXXXXXXXXXXXXXXXXXXXXXXXXXXXXX