-------------------------------------------------------------------------------------------
-------------------------------------------------------------------------------------------
-------------------------------------------------------------------------------------------
-------------------------------------------------------------------------------------------
-------------------------------------------------------------------------------------------
-------------------------------------------------------------------------------------------
----------------------!--------------------------------------------------------------------
-------------------------------------------------------------------------------------------
-------------------------------------------------------------------------------------------
----------------------------------------------------------------1--------------------------
----------------!---S@S!S------------xxxx----xtt---------tt--------------------------------
------------------xx------xxxx-------xttxx---xtt---------tt--------------------------------
-----------xx----x-x------x-ttxx----xxtt-x--xxtt---------tt----------------------------F---
---Mxxxxxxx-xxxxxx--xgxxxxx-tt-xxxxx-xtt-gxx-xtt-----g-g-tt----------------------------#---
XXXXXXXXXXXXXXXXXXXXXXXXXXXXXXXXXXXXXXXXXXXXXXXXXXXXXXXXXXXXXXXXXXXXXXXXXXXXXXXXXXXXXXXXXXX
XXXXXXXXXXXXXXXXXXXXXXXXXXXXXXXXXXXXXXXXXXXXXXXXXXXXXXXXXXXXXXXXXXXXXXXXXXXXXXXXXXXXXXXXXXX