-------------------------------------------------------------------------------------------
-------------------------------------------------------------------------------------------
-------------------------------------------------------------------------------------------
-------------------------------------------------------------------------------------------
-------------------------------------------------------------------------------------------
-----------------------g-------------------------------------------------------------------
---------------------SSSSSSSS---SSS!--------------@-----------SSS----S!!S------------------
-------------------------------------------------------------------------------------------
--------------------g----------------------------------------------------------------------
-----1-------------------------------------------------------------------------------------
---xx-xx----------S@S--------------C-----SU----!--!--!-----S----------SS-------------------
---xx-xxx----------------------------------------------------------------------------------
---xxxxxx------------------------------------------------------------------------------F---
---Mxxxxx---------------------------g-g--------k-----------------gg-g-g----------------#---
XXXXXXXXXX--XXXXXXXXXXXXXXX---XXXXXXXXXXXXXXXXXXXXXXXXXXXXXXXXXXXXXXXXXXXXXXXXXXXXXXXXXXXXX
XXXXXXXXXX--XXXXXXXXXXXXXXX---XXXXXXXXXXXXXXXXXXXXXXXXXXXXXXXXXXXXXXXXXXXXXXXXXXXXXXXXXXXXX