-----------------------------------------------------------------------------
-----------------------------------------------------------------------------
-----------------------------------------------------------------------------
---------------------------------------------------------------x-------------
--------------------------------------------------------------xx-------------
------------------------------------------------------------xxxxxx-----------
-------------xx-------------xx------------------------------xxx##x-----------
-------------x-x-----------x-xx---------------------------xxx-###-x----------
-----------xxx-x-----------x--x--------------------------xxxx####-x----------
--------xx-xx---x------x-xxx--x--------------------------x--#####--x---------
-------xxxxx#--#xx----x-xx##--#x-----xx----SS!S------xx-x--######--x---------
-------x--x##--##x---x---###--##xx--x-xx------x------x-xx-#######--x---------
-------x--###--###x--x--####--###xx-x-ttx-----xx----x-tt-########--x---xxF---
---Mxxx--####--####xxx-#####--####xxx-tt-xxxxxxxxggxx-tt#########---xxx--#---
XXXXXXXXXXXXXXXXXXXXXXXXXXXX--XXXXXXXXXXXXXXXXXXXXXXXXXXXXXXXXXXXXXXXXXXXXXXX
XXXXXXXXXXXXXXXXXXXXXXXXXXXX--XXXXXXXXXXXXXXXXXXXXXXXXXXXXXXXXXXXXXXXXXXXXXXX