----------------------------------------------------------------------------
----------------------------------------------------------------------------
----------------------------------------------------------------------------
---------------------------------------------------------------x------------
--------------------------------------------------------------xx------------
------------------------------------------------------------xxxxxx----------
-------------xx-------------xx------------------------------xxx--x----------
-------------x-x-----------x-xx---------------------------xxx-----x---------
-----------xxx-x-----------x--x--------------------------xxxx-----x---------
--------xx-xx---x------x-xxx--x--------------------------x---------x--------
-------xxxxx----xx----x-xx-----x-----xx--------------xx-x----------x--------
-------x--x------x---x----------xx--x-xx------x------x-xx----------x--------
-------x----------x--x-----------xx-x---x-----xx----x--------------x---xxx--
---xxxx------------xxx------------xxx----xxxxxxxxxxxx---------------xxx-----
----------------------------------------------------------------------------
----------------------------------------------------------------------------