----------------------------------------------------------------------------------------------------------------------------------------------------------------------------------------------------------
----------------------------------------------------------------------------------------------------------------------------------------------------------------------------------------------------------
----------------------------------------------------------------------------------------------------------------------------------------------------------------------------------------------------------
-------------------------------------------------------------------------------------------------------------------------------------------------------------------------------------------x--------------
------------------------------------------------------------------------------------------------------------------------------------------------------------------------------------------xxx-------------
----------------------------------------------------------------------------------g------------------------------------------------------------------------------------------------------xxxxxx-----------
----------------------!---------------------------------------------------------SSSSSSSS---SSS!--------------@-----------SSS----S!!S------xxx------------xxx-----------------------------x-x##x-----------
------------------------------------------------------------------------------------------------------------------------------------------x-x----------x-x-x---------------------------x-x-###-x----------
-------------------------------------------------------------------------------g--------------------------------------------------------xx--x---------xxx---x-------------------------x-xx####-x----------
----------------------------x--------xx------xxxx-------xxx-----1----------------------xx----------------------------------------------xxx---x------xxxxx---x------------------------x---#####--x---------
----------------!---S@S!S--x-x------xxxxx----xttxx-----xxttx---------xxx-x---S@S------xxx---x-C-----SU-x--!--!--!-----S--x-------SS--xxx-#--#x-----x-xx##--#x-----xx----SS!S-----xxx-x--######--x----xx---
------------------xx------x--xx-----x-ttx-xx-xtt-xxxxxxx-tt-x--------x-x-xxx----------x--x--x----------xx----------------xxx---------xxx##--##x---x---###--##xx--x-xx------x-----x-xxx-#######--x---x-----
-----------------xxx------x-ttx-----x-tt-x-xx-tt--x-xx-x-tt-x-------x---xxxx---------x---x-xx---------xxx---------------xxxx--------xx-###--###x--x--####--###xx-x-ttx-----x-----x-tt-########--x---x-F---
---Mxxxxxxxxxxxxxxxxxgxxxxx-ttxxxxxx--tt-g--x-tt--x--g-g-tt--xxxxxxxx---xxxxxxxxxxxxxx----xxxxxgxgxxxxxxxxkxxxxxxxxxxxxxxxx-ggxgxgxxxx####--####xxx-#####--####xxx-tt-xxxxxxxxggx--tt#########---xxxx-#---
XXXXXXXXXXXXXXXXXXXXXXXXXXXXXXXXXXXXXXXXXXXXXXXXXXXXXXXXXXXXXXXXXXXXX--XXXXXXXXXXXXXXX---XXXXXXXXXXXXXXXXXXXXXXXXXXXXXXXXXXXXXXXXXXXXXXXXXXXXXXXXXXXXXXXX--XXXXXXXXXXXXXXXXXXXXXXXXXXXXXXXXXXXXXXXXXXXXXXX
XXXXXXXXXXXXXXXXXXXXXXXXXXXXXXXXXXXXXXXXXXXXXXXXXXXXXXXXXXXXXXXXXXXXX--XXXXXXXXXXXXXXX---XXXXXXXXXXXXXXXXXXXXXXXXXXXXXXXXXXXXXXXXXXXXXXXXXXXXXXXXXXXXXXXX--XXXXXXXXXXXXXXXXXXXXXXXXXXXXXXXXXXXXXXXXXXXXXXX