-------------------------------------------------------------------------------------------
-------------------------------------------------------------------------------------------
-------------------------------------------------------------------------------------------
-------------------------------------------------------------------------------------------
-------------------------------------------------------------------------------------------
-----------------------g-------------------------------------------------------------------
---------------------SSSSSSSS---SSS!--------------@-----------SSS----S!!S------------------
-------------------------------------------------------------------------------------------
--------------------g----------------------------------------------------------------------
-----1xx-----------------------------------------------------------------------------------
------xx----------S@S--------------C-----SU----!--!--!-----S----------SS-------------------
-----xxxx----------------------------------------------------------------------------------
-----xxxx------------------------------------------------------------------------------F---
---Mxxxxx---------------------------g-g--------k-----------------gg-g-g----------------#---
XXXXXXXXXX--XXXXXXXXXXXXXXX---XXXXXXXXXXXXXXXXXXXXXXXXXXXXXXXXXXXXXXXXXXXXXXXXXXXXXXXXXXXXX
XXXXXXXXXX--XXXXXXXXXXXXXXX---XXXXXXXXXXXXXXXXXXXXXXXXXXXXXXXXXXXXXXXXXXXXXXXXXXXXXXXXXXXXX