-------------------------------------------------------------------------------------------
-------------------------------------------------------------------------------------------
-------------------------------------------------------------------------------------------
-------------------------------------------------------------------------------------------
-------------------------------------------------------------------------------------------
-------------------------------------------------------------------------------------------
----------------------!--------------------------------------------------------------------
-------------------------------------------------------------------------------------------
-------------------------------------------------------------------------------------------
----------------------------xx-------xx------xxxx-------xxxx----1--------------------------
----------------!-x-S@S!S--xxx------xxxxx----xttxx-----xxttxx-------------------------xx---
-----------------xx--------x--x-----x-ttx-xx-xtt-xxxxxxx-tt-x------------------------x-----
-----------------xx-------x-ttx-----x-tt-xx-xxtt--x-xxxx-tt--x-----------------------x-F---
---Mxxxxxxxxxxxxxxxxxgxxxxx-tt-xxxxx--tt-g--xxtt--x--gxg-tt--xxxxxxxxxxxxxxxxxxxxxxxxx-#---
XXXXXXXXXXXXXXXXXXXXXXXXXXXXXXXXXXXXXXXXXXXXXXXXXXXXXXXXXXXXXXXXXXXXXXXXXXXXXXXXXXXXXXXXXXX
XXXXXXXXXXXXXXXXXXXXXXXXXXXXXXXXXXXXXXXXXXXXXXXXXXXXXXXXXXXXXXXXXXXXXXXXXXXXXXXXXXXXXXXXXXX