-----------------------------------------------------------------------------
-----------------------------------------------------------------------------
-----------------------------------------------------------------------------
-----------------------------------------------------------------------------
-----------------------------------------------------------------------------
-----------------------------------------------------------------------------
-----------xx--------------------------------------------------##------------
-----------xx-------------------------------------------------###------------
----------xxxx-----------------------------------------------####------------
----------xxxx----------------------------------------------#####------------
--------xxxx#--#----------##--#------------SS!S------------######------------
--------x-x##--##--------###--##--------------------------#######------------
---x---x--###--###------####--###-----tt--------------tt-########--------F---
--xMxxxx-####--####----#####--####----tt---------gg---tt#########--------#---
XXXXXXXXXXXXXXXXXXXXXXXXXXXX--XXXXXXXXXXXXXXXXXXXXXXXXXXXXXXXXXXXXXXXXXXXXXXX
XXXXXXXXXXXXXXXXXXXXXXXXXXXX--XXXXXXXXXXXXXXXXXXXXXXXXXXXXXXXXXXXXXXXXXXXXXXX