----------------------------------------------------------------------------
----------------------------------------------------------------------------
----------------------------------------------------------------------------
--------------------------------------------------------------xx------------
-------------------------------------------------------------xxx------------
-----------------------------------------------------------xxx-xx-----------
------------x---xx----------------------------------------xxxx---x----------
-----------xx---xx-------x-----xxx------------------------xxxx---xx---------
-----------xx---x-x-----xxx-xx-x-x------------------------xx------x---------
-----------x-xxx--x---x-x-xxx-xx-xx---------------------xxxx------x---------
----xx---xxx-xx---x--xxxx---------x--xx--------------xx-xxx--------x--x-----
----xx--x----xx---x--x--x---------x--xxxx-xx-----xx--xxxx----------x-xxx----
----xx--x----xx----xx-------------x--x--x-xx--xxx-xx-x--x----------x-x--xx--
---x--xxx----xx----xx--------------xxx--xxx-xxx-x--xxx--------------xx------
----------------------------------------------------------------------------
----------------------------------------------------------------------------