-------------------------------------------------------------------------------------------
-------------------------------------------------------------------------------------------
-------------------------------------------------------------------------------------------
-------------------------------------------------------------------------------------------
-------------------------------------------------------------------------------------------
-----------------------g-------------------------------------------------------------------
---------------------SSSSSSSS---SSS!--------------@-----------SSS----S!!S------------------
-------------------------------------------------------------------------------------------
--------------------g----------------------------------------------------------------------
-----1----xx----------------xx-------------------------------------------------------------
---------xxx---x--S@S------xxxxxx--C-----SU----!--!--!-----S--xx------SS--------------xx---
---------x--x--xx----------x--xxxx---------xxxx--------------xxxx---------------------x----
--------x---x-xxx---------x---xxxxx--------xxxxx-------------xxxxx-------------------x-F---
---Mxxxxx----xxxxxxxxxxxxxx----xx-xxgxgxxxxxxx-kxxxxxxxxxxxxxxxx-ggxgxgxxxxxxxxxxxxxxx-#---
XXXXXXXXXX--XXXXXXXXXXXXXXX---XXXXXXXXXXXXXXXXXXXXXXXXXXXXXXXXXXXXXXXXXXXXXXXXXXXXXXXXXXXXX
XXXXXXXXXX--XXXXXXXXXXXXXXX---XXXXXXXXXXXXXXXXXXXXXXXXXXXXXXXXXXXXXXXXXXXXXXXXXXXXXXXXXXXXX