------------------------------------------------------------------------------------------------------------------------------------
------------------------------------------------------------------------------------------------------------------------------------
------------------------------------------------------------------------------------------------------------------------------------
------------------------------------------------------------------------------------------------------------------------------------
------------------------------------------------------------------------------------------------------------------------------------
----------------------------------------------------------------------------------------------------------------------!-!-----------
------------------------------------------------------------------------------------------------------------------------------------
---------------------------------------------------------------------------------------------------------------------!---!----------
-----------------------------------SS----------------------------------xxx--------------------------------------------!!!-----------
----------xx--------------------------------------------g------------xxxxxx-----------------xx------------00------------------------
---------xxxx---x-------xx---xxxxx-----x------xxx---x---SSSS SS-----xxxxx#x----------xxx---xxx----------x-------xx--------------x---
---------x--xx--xx-----x--x--x-ttx-xx--xxxx---x-x---xx--------xxx---x--x##xx---------x-x---x--xxxxx----x-x-----xxxx------------x----
---------x-ttx-xx-x----x--x--x-tt-xx-x-xttxx--x--x--xx-------xx-x---x--###-x--------x---x-x---xxxxxx---x-x-----xxxx------------xF---
---Mxxxxx--ttxxxx-xgxgxx---xx--tt-x--gxxtt-xxx---xxxxxxxxxxxxxx--gxg--####xxxxxkxxxxx---xxx---x-xg-gxxxx-xxxxkxxxxxxggxgxgxxxxxx#---
XXXXXXXXXXXXXXXXXXXXXXXXX--XXXXXXXXXXXXXXXXXXXX--XXXXXXXXXXXXXXXXXXXXXXXXXXXXXXXXXXXX--XXXX--XXXXXXXXXXXXXXXXXXXXXXXXXXXXXXXXXXXXXXX
XXXXXXXXXXXXXXXXXXXXXXXXX--XXXXXXXXXXXXXXXXXXXX--XXXXXXXXXXXXXXXXXXXXXXXXXXXXXXXXXXXX--XXXX--XXXXXXXXXXXXXXXXXXXXXXXXXXXXXXXXXXXXXXX