-------------------------------------------------------------------------------------------
-------------------------------------------------------------------------------------------
-------------------------------------------------------------------------------------------
-------------------------------------------------------------------------------------------
-------------------------------------------------------------------------------------------
-------------------------------------------------------------------------------------------
----------------------!--------------------------------------------------------------------
-------------------------------------------------------------------------------------------
----------------------------------------------xx-------------------------------------------
----------------------------x--------xx------xxxx-------xxxx----1--------------------------
----------------!---S@S!S--x-x------xxxxx----xttx------xxttxx-------------------------xx---
------------------xx------x--xx-----x-ttx-xx-xttx-xxxx-x-tt-x-------------------------x----
-----------------xxx------x-ttx-----x-tt-xx-x-tt-x-xxxxx-tt--x------------xxx-------xxxF---
---Mxxxxxxxxxxxxxxxxxgxxxxx-ttxxxxxx--tt-g--x-tt-x-xxgxg-tt--xxxxxxxxxxxxxx-xxxxxxxxx-x#---
XXXXXXXXXXXXXXXXXXXXXXXXXXXXXXXXXXXXXXXXXXXXXXXXXXXXXXXXXXXXXXXXXXXXXXXXXXXXXXXXXXXXXXXXXXX
XXXXXXXXXXXXXXXXXXXXXXXXXXXXXXXXXXXXXXXXXXXXXXXXXXXXXXXXXXXXXXXXXXXXXXXXXXXXXXXXXXXXXXXXXXX