------------------------------------------------------------------------------------------------------------------------------------
------------------------------------------------------------------------------------------------------------------------------------
------------------------------------------------------------------------------------------------------------------------------------
------------------------------------------------------------------------------------------------------------------------------------
------------------------------------------------------------------------------------------------------------------------------------
----------------------------------------------------------------------------------------------------------------------!-!-----------
------------------------------------------------------------------------------------------------------------------------------------
------------------------------------------------------------------------x--------------------------------------------!---!----------
-----------------------------------SS-----xx----------------------------xx--------------------------------------------!!!-----------
-------------------------x-----x----------x-x-----------g-------------x-xxx----------xx----xx-------------00------------------------
---------xxx-xxx--------xxx---xxxx----xx-x--x--xxx---x--SSSS SS------x-xx#x-----xx--xxxx--xxxx-------------------x-------------xx---
---------x-xxx-xx-------x--x-x-ttx-xx-xxxx--x--x--x--xx------xxx----x---##x-xx-x-x--x--x--x--x-xxxx-------xxx---xxx-xx--------x-----
---------x-tt--xxx-----x---x-x-tt-xx-xx-tt---x-x--x-x-xx-----xx-----x--###-xxx-x--x-x--xx-x--xxxx-x------x-xx--x-xxxxx--------x-F---
---Mxxxxx--tt-xxxxxgxgxx----xx-tt-x--gx-tt---xx----xx-xxxxxxxxxxxgxgx-####-x-xxk--xx----xx----x-xgxgxxxxxx-xxkxx-xxxggxgxgxxxxx-#---
XXXXXXXXXXXXXXXXXXXXXXXXX--XXXXXXXXXXXXXXXXXXXX--XXXXXXXXXXXXXXXXXXXXXXXXXXXXXXXXXXXX--XXXX--XXXXXXXXXXXXXXXXXXXXXXXXXXXXXXXXXXXXXXX
XXXXXXXXXXXXXXXXXXXXXXXXX--XXXXXXXXXXXXXXXXXXXX--XXXXXXXXXXXXXXXXXXXXXXXXXXXXXXXXXXXX--XXXX--XXXXXXXXXXXXXXXXXXXXXXXXXXXXXXXXXXXXXXX