-------------------------------------------------------------------------------------------
-------------------------------------------------------------------------------------------
-------------------------------------------------------------------------------------------
-------------------------------------------------------------------------------------------
-------------------------------------------------------------------------------------------
-------------------------------------------------------------------------------------------
----------------------!--------------------------------------------------------------------
-------------------------------------------------------------------------------------------
-------------------------------------------------------------------------------------------
----------------------------x--------xx------xxxx-------xxx-----1--------------------------
----------------!---S@S!S--x-x------xxxxx----xttxx-----xxttx--------------------------xx---
------------------xx------x--xx-----x-ttx-xx-xtt-xxxxxxx-tt-x------------------------x-----
-----------------xxx------x-ttx-----x-tt-xxxxxtt--x-xx-x-tt-x------------------------x-F---
---Mxxxxxxxxxxxxxxxxxgxxxxx-ttxxxxxx--tt-g--xxtt--x--g-g-tt--xxxxxxxxxxxxxxxxxxxxxxxxx-#---
XXXXXXXXXXXXXXXXXXXXXXXXXXXXXXXXXXXXXXXXXXXXXXXXXXXXXXXXXXXXXXXXXXXXXXXXXXXXXXXXXXXXXXXXXXX
XXXXXXXXXXXXXXXXXXXXXXXXXXXXXXXXXXXXXXXXXXXXXXXXXXXXXXXXXXXXXXXXXXXXXXXXXXXXXXXXXXXXXXXXXXX