x---------------------------------------------------------------------------------------------------------------------------------------------------------------------------------------------------------
-x--------------------------------------------------------------------------------------------------------------------------------------------------------------------------------------------------------
-x--------------------------------------------------------------------------------------------------------------------------------------------------------------------------------------------------------
-xx-------------------------------------------------------------------------------------------------------------------------------------------------------------------------------------------------------
--x-------------------------------------------------------------------------------------------------------------o-o-----------------------------o---------------------------------------------------------
---x--------g---------------------------------------------------------------------------------------------------%-%-------------------xxo---xxxx-o--oo------xxx------xxx------------------------xxxx------
---x------SSSSSSSS---SSS!--------------@-----------SSS----S!!S-----------------------xxxxx------------o--------o|o--------------%-%-%x---x--x--x-----------x---x----x--x---oo------------------x-##xx-----
----x-----------------------------------------------------------------xx------------x-----x----------o---------%|%------------xx|x|gx----oxx----x----------x-r--xxxx----x---xxxx--------------x--##--x----
----x----g-----------------------------------------------------------x--x-----------x------x--------------S-S---||------------x%|%|%------S------xx-------x%%%%%%%%------x--x--x------SSS-----x####---x---
-----x-----------------------------------------------------------xxxx---xx------xxxx-------x------------xxxxxxx-||--------%--x--||||--------------Sx-----x--||||||-------xxx----xx---------xxxx####----x--
-------S@S--------xxx---C-----SU----!--!--!-----S----------SS--xx--#--#--x----xx-##--#------x-----SS--xxx--S--Ux||--------|xx---||||-----S-------S--x----x--||||||-----%%%%--%%%%x-------xx--######----x--
-----x-----------x---xx--xxx-------xx-----------------xxxx----x---##--##--x---x-###--##------xx-------x---------||------x%|%----||||----------------xxxxxx--||||||------||----||--x-----x----######-----x-
------x---------x-----x-x---xx----x--x---------------x---x---x---###--###-x--x-####--###-----ttx-----x----------||x----x--|-----||||-----------------%%%%---||||||------||----||---x---x-----######-----x-
------xxxxxxxxxxx------x-g-g-xxxxx--k-xxxxxxxxxxxxxxx-gg-gxgxx--####--####-xxx#####--####----ttxxxxxx-%-%-----%-%|%x%-%x%-|-----||||------------------||----||||||--ooo-||----||---xxxxx-r---######------x
-XXXXXXXXXXXXXXX---XXXXXXXXXXXXXXXXXXXXXXXXXXXXXXXXXXXXXXXXXXXXXXXXXXXXXXXXXXXXXXXX--XXXXXXXXXXXXXXX-%|---------||--xx|---|-----||||------------------||----||||||--%%%-||----||----XXXXXXXXXXXXXXXXXXXXXX
-XXXXXXXXXXXXXXX---XXXXXXXXXXXXXXXXXXXXXXXXXXXXXXXXXXXXXXXXXXXXXXXXXXXXXXXXXXXXXXXX--XXXXXXXXXXXXXXX--|%------|%|%--|%|%--------||||------------------||----||||||---|--||----||----XXXXXXXXXXXXXXXXXXXXXX