----------------------------------------------------------------------------------------------------------------------------------------------------------------------------------------------------------
----------------------------------------------------------------------------------------------------------------------------------------------------------------------------------------------------------
----------------------------------------------------------------------------------------------------------------------------------------------------------------------------------------------------------
------------------------------------------------------------------------------------------------------------------------------------------------------------------------------U---------------------------
-----------xx---------------------------------------------------------------------------------------------------------------------------------------------------------------------------------------------
---------xx--x------------------------------------------------------------------------------------------------K---------------------------------------------------------------------------------k---------
---------x----xx----------xx-----------------------------1------------------------------------------------SSSSSS----1----------------------------------------SSSSS------------------------------##--------
--------x------x---------xx-xy----------------------------------------oooo----------oooo----------------------------------------------------------------------------------------SS-------------###--------
---xxyxx-------x---------x-#SSxxo----------------------------------------------------------------------------------------------------------------------------------------------------#--------####--------
---x-XSS-?Q-----x-------x-##---xx-----------------------------------------------xxx------------------------K--------------------------------------------------K-------------SS------##-------#####--------
--x-XX----------x----xxxx###--SCx----------------------QQQQ-------xxxx--------xxxTT--------------TT------SSSSSSS---------------------------------------------SSSSS-----------------###------######--------
xxxXXX-----------x--x---####-----xx--------xxxx---------xx-------x--#xx-------x--TT--------------TT-T---------------TT--------------TT--------------------------K---#----B--------####-----#######--------
x-XXXX-------y---x--x--#####---SSSx--------x---x-------x--x------x--#--x-----x---TT--------------TT-T---------------TT---------B----TT----TT-----B-----TT-----------#----b-------#####----########--------
xXXXXX---SSSSS----xy--######-------xxxxxxxx-----xxxxxxx-yy-xxxxxx---#---xxxxx-y--TT---y------y---TT-T---------------TT---------b----TT-k--TT-----b-----TT-----------#----B------######---#########--------
XXXXXX-------XX-XXXXXXXXXXXX------XXXXXXXXX----XXXXXXXXXXXXXXXXXXXXXXXXXXXXXXXXXXXXXXXXXXXXXXXXXXXXXXXXXXXXXXXXXXXXXXXXXXXXXXXXXXXXXXXXXXXXXXXXXXXXXXXXXXXXXXXXXXXXXXXXXXXXXXXX-XXXXXXXXXXXXXXXXXXXXXXXXXX
XXXXXX-------XX-XXXXXXXXXXXX------XXXXXXXXX----XXXXXXXXXXXXXXXXXXXXXXXXXXXXXXXXXXXXXXXXXXXXXXXXXXXXXXXXXXXXXXXXXXXXXXXXXXXXXXXXXXXXXXXXXXXXXXXXXXXXXXXXXXXXXXXXXXXXXXXXXXXXXXXX-XXXXXXXXXXXXXXXXXXXXXXXXXX