------------------------------------------------------------------------------------------------------------------------------------------------------------------------------------------------------
------------------------------------------------------------------------------------------------------------------------------------------------------------------------------------------------------
------------------------------------------------------------------------------------------------------------------------------------------------------------------------------------------------------
-------------------------------------------------------------------------------------------------------------------------------------------------------------------------------------------xxx--------
-------------------------------------------------------------------------------------------------------------------------------------------------------------------------------------------x--x-------
---------------------------------------------------------------------------------------------------------------------------------------------------------------------------------------xxxx---xx------
-------------------------------------------------------------------------------------SUS-----------------------------------------------------------------------------------------------x##------x-----
--------------------------------------------------------------------------------------------------------------------------------------------------xxx----------xx---------------------x-##------x-----
---------------------------------------xx---------------------------------------------------------------------------------------------------------x-x--TT----xx--x---------------xxxxxx-##-------x----
---------------------------------------xx------xx---x------------------------------xxxxxxx-----------xx------xxx-----------------------------xxxxx--xx-TT---x-----x--------------K---#--##-------x----
------------------------------------xxxxx----xx-xx-xxxx--------------------------xx-#####xxx-------xx--xx---x---x--------------------------xx-#LSS---x-##---x------x-----------xx---##--##--------x---
--------xxx--xxxx--------xxxx-------x--TTx---xTT-xx-K--x---xxx------xxxx--------x---#------xx-----x-----xxxx---#-x--xxxx-xxxxx--xxxx------x---#------x---xxx--------xx-------xxx---###--##------------
-------x---x-x---x------x---x------x---TTx--x-TT--x-----x-x---xx----x---x-------x--K#--------x---x--------*----#--xx---x-x---x--x---x-----x---#-------x-x-*---TT-----*x------x----####------------F---
-Mxxxxxx--k-x-ggg-xxxxxx-ggg-xxxxxx--kkTT-xxx-TT---------x-ggg-xxxxx-gggxxxxxxxx----#--------xxxxx-ggg----*----#---xggg-xk----ggg----xxxxx--kk#-------xxx-*---TT-----*xxxxxKx----#####------------#---
XXXXXXXXXXXXXXXXXXXXXXXXXXXXXXXXXXXXXXXXXXXX--XXXXXXXXXXXXXXXXXXXXXXXXXXXXXXXXXXXXXXXXX----XXXXXXXXXXXXXXXXXX--XXXXXXXXXXXXXXXXXXXXXXXXXXXXXXXXXXXX---XXXXXXXXXXXXXXXXXXXXXXXXXXXXXXXXXXXXXXXXXXXXXXXX
XXXXXXXXXXXXXXXXXXXXXXXXXXXXXXXXXXXXXXXXXXXX--XXXXXXXXXXXXXXXXXXXXXXXXXXXXXXXXXXXXXXXXX----XXXXXXXXXXXXXXXXXX--XXXXXXXXXXXXXXXXXXXXXXXXXXXXXXXXXXXX---XXXXXXXXXXXXXXXXXXXXXXXXXXXXXXXXXXXXXXXXXXXXXXXX