---------------------------------------------------------------------------------------------------------------------------------------------------------------------
---------------------------------------------------------------------------------------------------------------------------------------------------------------------
---------------------------------------------------------------------------------------------------------------------------------------------------------------------
-----------------------oo-------------------------------------------------------ooo----------------------------------------------------------------------------------
--------------------------------------------------?-----------------------------%%%------------------------------------------------------------------oo--------------
--------------------------------------ooooooo------------------------------------|-----------------------------------------------------------------------------------
----------------------SSSS---------SSSS---------------------------SSoo----SS-----|----------------------------------------oo---%%%%--------------------%%%%----------
------------------------------------------------SSSS---------------xx-----xx-----|-------------------------------SSS------SS----||--------------SSS-----||-----------
-----------------------------------------SSSS--------------xxxx---x-xx---x--x----|----------------------------------------------||------SSS-oo----------||-----------
---------------------------------------------------xxx----x---xxxxx---xxx----xx--|---%%%%------oooo-xxxxxxxx--------------------||-----xx---------------||-----------
------------xxxx%%%%----xx%%%%%-------xxxxx-------x---xxxxx-%%%%%%----SS-----SSxx|xxxx||----------xxx-%%%%%%xx---------------SS-||%%%%%--x--SS----------||-----------
------------x---x||----x---|||-------x-----xxxxxxx-----SSS---||||---------------%%%%%%||x---------x----||||---xx---xxxx-----xx--||-|||----xx------------||-----------
-----------x-----||----x---|||x-----x-------%%%%%------------||||----------------||||-||x--------x-----||||----x---x---x---x--x-||-|||-----x------------||---------F-
-Mxxxxxxxxx------||xxxx----|||-xxxxxx--------|||-------------||||----------------||||-||-xxxxxxxx------||||-----xxx-----xxx----x||x|||------x-----------||---------X-
XXXXXXXXXXX--%%%%||%%%%----|||--%%%%--%%%%---|||-------------||||----------------||||-||%%%%%%%%%-%%%%-||||-%%%%%%----%%%%-----%%%%|||------x-----------||-XXXXXXXXXX
XXXXXXXXXXX---||-||-||-----|||---||----||----|||-------------||||----------------||||-||-|||||||---||--||||--||||------||-------||-|||-------x----------||-XXXXXXXXXX