-------------------------------------------------------------------------------------------------------------------------------------------------------------------------------------------------------------------------------------------------------------------------------------------------------------------------------------------------------------------------------------
-------------------------------------------------------------------------------------------------------------------------------------------------------------------------------------------------------------------------------------------------------------------------------------------------------------------------------------------------------------------------------------
-------------------------------------------------------------------------------------------------------------------------------------------------------------------------------------------------------------------------------------------------------------------------------------------------------------------------------------------------------------------------------------
-------------------------------------------------------------------------------------------------------------------------------------------------------------------------------------------------------------------------------------------------------------------------------------------------------------------------------------------------------------------------------------
-------------------------------------------------------------------------------------------------------------------------------------------------------------------------------------------------------------------------------------------------------------------------------------------------------------------------------------------------------------------------------------
------------------------------------------------------------------------xx----------------------------oo-----------------------------------------------------------------------------------------------------------------------------------------------------------------------------------------------------------------------------------------------------------------------------
----------------------------------------------------------------------xx-xx------------------------------------------------------------------------SSSSCSSS------------------------------------------------------------------------------------------------------------------------------------------------------------------------------------------------------------##------------
----------------------------xx----------------------------------------x---xx-------------------------------------------------------------------------------------------------------------------------------------------------------------------------------------------------------------------------------------------------------------------------------------------##------------
----------------------------x-x--------------------------------------x-----x-----------------------------------------------------------------------------------------------------------------------------------------------------------------------------------------------------#-----------------------------------------------------------------------------------#-##------------
---------------------------xx-xx-------------------------o----------xx---1--x-----o--xxxx--o-------------------------------------------------------------------------------------SSUSSSSS-------------------------------oo---------------------tt-------------------------------##--oo------o----o-------------------oo---oo-----------------------------------------#-##------------
-------------------x-----xx-TT-x-------------xxxx-------------------xTT------x-----xx--TT--------TT-----------------------------------------------#----2----#------------------------------------------------------------------------------TT--tt------------------------------###---------------------------------------------------------------------------------#-#-##------------
------------xxx--xxxxx--xx--TT--x-xxxxx------x---x-xxxxx-----xxxx---xTT----TTx----x----TT--------TT----------------------------------TT-----------#------K--#-------K------------------------------------------------------------------TT--TT--tt-----------------------------####---------------------------------------------------------------TT----------------#-#-##------------
-----------x---x-x----xx----TT--x-x---x-----x------x----x---x---x---xTT----TT-x---x----TT--------TT---------tt-----------------------TT-----------#---------#-----------K----------------------------------#---------------------------TT--TT--tt----------------------------#####----------------------#---#------------------------------------TT---------TT---#-#-#-##--------F---
-Mxxxxxxxxx---kxggg----xggg-TT---xk-k--xxxxx------x-k---xxxxx-gggxxxxTT---kTT--xxx-----TT--------TT---ggg---tt-k----kkk---kkk--------TT------ggg--#---------#--------------------------------------------kk#----------------------ggg--TT--TT--tt-----k--ggg-----ggg------gg######--k-------------------#-k-#-----------------------k------kkk---TT---------TT---#-#-#-##--------#---
XXXXXXXXXXXXXXXXXXXXXXXXXXXXXXXXXXXXXXX-X-XX-XX-XX-XXXXXXXXXXXXXXXXXXXXXXXXXXXXXXXXXXXXXXXXXXXXXXXXXXXXXXXXXXXXXXXXXXXXXXXXXXXXXXXXXXXXXXXXXXXXXXXXXXXXXXXXXXXXXXX-X-XX-X-XX-XXXXXXXXXXXXXXXXX-X-X-XXXXXXXXXXXXXXXXXXX------XXXXXXXXXX-XX--XX--XXXXXXXXXXXXXXXXXXXXXXXXXXXXXXXXXXXXXXXXXXXX---XX---XXXXXXXXXXXXXXXX-----X----XXXXXXXXXXXXXXXXXXXXXXXXXXXXXXXXXXX-X-X-X-XXXXXXXXXXXXXX
XXXXXXXXXXXXXXXXXXXXXXXXXXXXXXXXXXXXXXX-X-XX-XX-XX-XXXXXXXXXXXXXXXXXXXXXXXXXXXXXXXXXXXXXXXXXXXXXXXXXXXXXXXXXXXXXXXXXXXXXXXXXXXXXXXXXXXXXXXXXXXXXXXXXXXXXXXXXXXXXXX-X-XX-X-XX-XXXXXXXXXXXXXXXXX-X-X-XXXXXXXXXXXXXXXXXXX------XXXXXXXXXX-XX--XX--XXXXXXXXXXXXXXXXXXXXXXXXXXXXXXXXXXXXXXXXXXXX---XX---XXXXXXXXXXXXXXXX-----X----XXXXXXXXXXXXXXXXXXXXXXXXXXXXXXXXXXX-X-X-X-XXXXXXXXXXXXXX