------------------------------------------------------------------------------------------------------------------------------------------------------
------------------------------------------------------------------------------------------------------------------------------------------------------
------------------------------------------------------------------------------------------------------------------------------------------------------
--------------------------------oo--------------------------------------------------------------------------------------------------------------------
---------------------------------------g-g------------------------------------------------------------------------------------------------------------
----------------------ooor---------%%%%%%%-------------oooo----------R------------------oo--oo--------------------------------------------------------
---------------------%%%%%----------|||||--------------%%%%----------------g----oo---------------------------R-----oo--------------------##-----------
----------------------|||---xxxx---x|||||----oo---SSSS--||-------------%%%%%%----------------------------r-------------------------------##-----------
----------------------|||--x---xxxxx|||||x--------------||--------------||||-----------------------%%%%%%%%----------------------------####-----------
-------------------xxx|||xxx--%%%%%-|||||-x-------------||-----------xx-||||-----SSS----------------||||||---------------------SSS-----####-----------
------------------x%%%%%%%%----|||--|||||-x-------xxxxx-||-------%%%x--x||||-------------SSS--------||||||-----%%%%--%%%%------------######-----------
------------xxx---x-||||||-----|||--|||||--x------x---Ux||--------|-----||||------------------------||||||------||----||-------------######-----------
-----------x---xxx--||||||--o--|||--|||||---x----x------||-------x|-----||||-----------------%%%%---||||||------||----||-------------######--------F--
xxxxxxxxxxxx-%%%%---||||||-%%%-|||--|||||---xxxxx-------||xxxxxxxx|-----||||------------------||----||||||--ooo-||----||---------r---######--------#--
XXXXXXXXXXX---||----||||||--|--|||--|||||----%%%%-----%%%%%-%%%%%-|-----||||------------------||----||||||--%%%-||----||----XXXXXXXXXXXXXXXXXXXXXXXXXX
XXXXXXXXXXX---||----||||||--|--|||--|||||-----||-------|||---|||--|-----||||x-----------------||----||||||---|--||----||----XXXXXXXXXXXXXXXXXXXXXXXXXX