-----------------------------------------------------------------------------------------------------------------------------------------------------
-----------------------------------------------------------------------------------------------------------------------------------------------------
-----------------------------------------------------------------------------------------------------------------------------------------------------
---------------------------------------------------oo------------------------------------------------------------------------------------------------
--------------------------------------------?-----%%%%-------------------o---------------------------------------------------------------------------
-----------------------SSS-------------------------||-------------------%%%-------------------------oo-----------------------------------------------
---------------------------------------------------||--------------------|--o------o--o---SSS------%%%%----------------------------SSSS--------------
---------------------g----------o----ooo------r----||--SSS---o---o---o---|--SSSS--------------------||--o----R---------------------------------------
-----------------%%%%%%-------------------%%%%%%-xx||x------%%%-%%%-%%%--|--------------------------||-%%%-------------------SSS---------------------
-----------------x||||----SSS--------------||||-x--||-xx-----|---|---|---|---------SSSS-------------||--|------------------------------SSSS----------
------------xxxxxx||||x---------------%%%%-||||ooo-||--x-----|---|---|---|------------------%%%-----||--|-------------r-r----------------------------
------------x%%%%%||||-x-----xxxx-----x||xx||||x-r-||---x----|---|---|---|-------------------|------||-o|---------%%%%%%%%%%%%-----------------------
-----------x--|||-||||--x---x---xxxxxx-||%%%%%%%%%%||----x---|---|---|---|-----%%%%----------|------||%%%%%--------||||||||||----------------------F-
-Mxxxxxxxxx---|||-||||--xxoox--%%%%%%%-||-||||||||-||-----x--|---|-r-|---|------||-----------|------||-|||---------||||||||||----------------------#-
XXXXXXXXXXX---|||-||||---%%%----|||||--||-||||||||-||-----x-%%%%%%%%%%%%%%%%----||-----------|------||-|||-----%%%-||||||||||--------------XXXXXXXXXX
XXXXXXXXXXX---|||-||||----|-----|||||--||-||||||||-||------x-||||||||||||||-----||-----------|------||-|||------|--||||||||||--------------XXXXXXXXXX