------------------------------------------------------------------------------------------------------------------------------------------------------
------------------------------------------------------------------------------------------------------------------------------------------------------
------------------------------------------------------------------------------------------------------------------------------------------------------
--------------------------------oo--------------------------------------------------------------------------------------------------------------------
-------------------------------------g-g--------------------------------------------------------------------------------------------------------------
----------------------ooor---------%%%%%%%-------------oooo----------R------------------oo--oo--------------------------------------------------------
---------------------%%%%%----------|||||--------------%%%%----------------g----oo---------------------------R-----oo--------------------##-----------
----------------------|||---xxx----x|||||----oo---------||-------------%%%%%%------------------------r-----------------------------------##-----------
----------------------|||--x---xxxx-|||||---------------||xx------------||||-----------------------%%%%%%%%-------------------SSS------####-----------
-------------------xxx|||xx---%%%%%-|||||x--------SSS--x||--x--------xxx||||-----SS-----------------||||||-----------------------------####-----------
------------------x%%%%%%%%----|||--|||||-x--------xxxxx||--xx---%%%xx-x||||-------------SS---------||||||-----%%%%--%%%%------------######-----------
------------xxx--x--||||||-----|||--|||||--x-------x--U-||---x----|x----||||------------------------||||||------||----||-------------######-----------
-----------x---xxx--||||||--o--|||--|||||--x------x-----||----x---|-----||||-----------------%%%%---||||||------||----||-------------######--------F--
-Mxxxxxxxxx--%%%%---||||||-%%%-|||--|||||---xxxxxx------||-----xxx|-----||||------------------||----||||||--ooo-||----||---------r---######--------#--
XXXXXXXXXXX---||----||||||--|--|||--|||||----%%%%-----%%%%%-%%%%%-|-----||||------------------||----||||||--%%%-||----||----XXXXXXXXXXXXXXXXXXXXXXXXXX
XXXXXXXXXXX---||----||||||--|--|||--|||||-----||-------|||---|||--|-----||||x-----------------||----||||||---|--||----||----XXXXXXXXXXXXXXXXXXXXXXXXXX