------------------------------------------------------------------------------------------------------------------------------------------------------------------------------------------------------------------------------
------------------------------------------------------------------------------------------------------------------------------------------------------------------------------------------------------------------------------
------------------------------------------------------------------------------------------------------------------------------------------------------------------------------------------------------------------------------
-------------------------------------------------------------------------------------------------------------------------------------------------------------------------------------------------------------------x----------
------------------------------------------------------------------------------------------------------------------------------------------------------------------------------------------------------------------xx----------
--------------------------------------------------------------------------------------------------------------------------------------------------------------------------------------------------------------xxyxxx----------
------------------Q--------------------------------------Q-Q-------------------------1-------------------------------------------------------QQQQ------------------------------------------------------------xx-##-x----------
--------------------------------------------------------------------------------------------------oooo--------xxoooo---------xxxoooo-------------------------------------------------------------------------xy###-x----------
-------------------------------------------------------------------------------------------------------------x--x------------x-x---------------------------------------------------------------------------xx-####-x----------
-----------------------------------oo----------------------------------------------------------------------xxx--xx---------xxx--x--------------y-----------------------------------------------------------xx#####-x----------
-------------xxxx-?---------------o--o-------------------Q-Q-----------------------QQQQ--------xxxx-------xxxTT--x-------xxx-TT--x---------QQ?SSQQQ--------xxxx----------xxx---------xxxx----------------xxx######--xC--------
-------------xTT-x--------xxxx-----------------xxx----------xxxx---------xxx-------xxx--------x-#-xx-----x-xxTT---x------x---TT--x--------------xx--------x----x--------x---xx------x-#-xx----xxxx-----xxx-#######--x----xx---
------------x-TT--x-------x---x---------------x---x---------x---x-------x---x------x-xx-------x-#---x----x-xxTT---x-----x----TT---x------------x--x-------x-TT--x------x------x-----x-#---x--x---x----x-xx########--x---x-F---
-Mxxxxxxxxxx--TT--xxxxxxxx----xxxxxxxxxxxxxxxx-y---xxxxxxxxx-y--xxxxxxxx-----xxxxxx-yy-xxxxxxx--#---xxxxx-yx-TT---yxxxxx-y---TT---xxxxxxxxxxxxx----xxxxxxx--TT---xxxxxxx------xxxxxx--#---xyxxy---xxxxx--#########--xxxxx-#---
XXXXXXXXXXXXXXXXXXXXXXXXX--XXXXXXXXXXXXXXXXXXXXXXXXXXXXXXXXXXXXXXXXXXXX----XXXXXXXXXXXXXXXXXXXXXXXXXXXXXXXXXXXXXXXXXXXXXXXXXXXXXXXXXXXXXXXXXXX--XXXXXXXXXXXXXXXXXXXXXXX---XXX--XXXXXXXX--XXXXXXXXXXXXXXXXXXXXXXXXXXXXXXXXXXXXX
XXXXXXXXXXXXXXXXXXXXXXXXX--XXXXXXXXXXXXXXXXXXXXXXXXXXXXXXXXXXXXXXXXXXXX----XXXXXXXXXXXXXXXXXXXXXXXXXXXXXXXXXXXXXXXXXXXXXXXXXXXXXXXXXXXXXXXXXXX--XXXXXXXXXXXXXXXXXXXXXXX---XXX--XXXXXXXX--XXXXXXXXXXXXXXXXXXXXXXXXXXXXXXXXXXXXX