--------------------------------------------------------------------------------------------------------------------------------------------------------------------------------
--------------------------------------------------------------------------------------------------------------------------------------------------------------------------------
--------------------------------------------------------------------------------------------------------------------------------------------------------------------------------
------------------------------------------------------------------------------------------------------------------------------------------------U-------------------------------
----------------------------------------------------------------------------------------------------------------------------------------------------------xxxxx---xxxx----------
--------------------------------------------------------------------------------K-----------------------------------------------------------------xxx-----x----x-xk---x---------
--------------------USS-----------------------------------------------------SSSSSS----1----------------------------------------SSSSS-------------x---x---x------xx##--xx--------
------------------------------------------------------------------xx-----------------------------------------------------------------------------xSS--xxx--------###----x-------
---------------------------------------------------------B------xx--x------------------------------xxxx-------x-------xxx-------------xxxx---xxxx------#--------####----x-------
---------------------------------------------------------b-----x-----xx------K--------xxx----------x--xx----xx-xx----x---xx-----K----x---xx--xSS------##-------#####-----x------
--------------------xxxx--------QQQQ-xxxxx---xxxxx-----SS#CS--x-------x----SSSSSSS--xx--xx---------x---x---x----xx--x-----x----SSSSS-x-----xx--------###------######-----x------
----------xxxx---K-x-B-xx---xxxx----xK-B-xx--K---Bxx-------xxxx------TTx-----------x--TT--x----xxxx---TTx-x-------xxx------x-----xK-x-#----B--------####-----#######------x-----
----------x-Bx-----x-b--x---xB-x---x---b---xx----b-x-----xxK-B-------TT-x----------x--TT---x--x--B----TTx-x-TT-----B-----TT-x---x-xx--#----b-------#####----########-------xF---
-Mxxxxxxxx--b-xxxxx--B---xxx-b--xxxx---b---------B--xxxxx----b-------TT--xxxxxxxxxx---TT----xxx--b----TT-k--TT-----b-----TT-xxxxx-----#----B------######---#########--------#---
XXXXXXXXXXXXXXXXXXXXXXXXXXXXXXXXXXXXXXXXXXXXXXXXXXXXXXXXXXXXXXXXXX--XXXXXXXXXXXXXXXXXXXXXXXXXXXXXXXXXXXXXXXXXXXXXXXXXXXXXXXXXXXXXXXXXXXXXXXXXXXXX-XXXXXXXXXXXXXXXXXXXXXXXXXXXXXX
XXXXXXXXXXXXXXXXXXXXXXXXXXXXXXXXXXXXXXXXXXXXXXXXXXXXXXXXXXXXXXXXXX--XXXXXXXXXXXXXXXXXXXXXXXXXXXXXXXXXXXXXXXXXXXXXXXXXXXXXXXXXXXXXXXXXXXXXXXXXXXXX-XXXXXXXXXXXXXXXXXXXXXXXXXXXXXX