----------------------------------------------------------------------------------------------------------------------------------------------------------------------------------------------------------
----------------------------------------------------------------------------------------------------------------------------------------------------------------------------------------------------------
----------------------------------------------------------------------------------------------------------------------------------------------------------------------------------------------------------
----------------------------------------------------------------------------------------------------------------------------------------------------------------------------------------------------------
----------------------------------------------------------------------------------------------------------------------------------------------------------------------------------------------------------
----------------------------------------------------------------------------------------------------------------------------------------------------------------------------------------------------------
---------------------------------------------------------------------------------S---------------------------------------------------------------------------------S--------------------------------------
----------------------------------------------------------------------------------------------------------------------------------------------------------------------------------------------------------
-----------------------------------------------------------xx-----------------------------------------xxxx----------------------------------xxx-----------------------------------------xxxx--------------
---------------------------------------------------------xx--xxx--------------------------------------x--x------------xxxx-----------------xx-xxxx--------------------------------------x--x--------------
------xxxxx------------------------SSU-------------S-SkS-x----Txx----------SC-------xxxx--SUS-----xxxx----xx--------xx--SUxx---------S-SkSx-----Txx----------SC--------xxxx-SUS-----xxxx----xx--------xxx-
------x----x-----------------------xx---------------CKSxx----TT--x--------xxx-------x-t-xx-------x--t------x-------xg-------x---------CKSxx----TT--x---------xx-------x-t-xx-------x--t------x-------xg--x
-----x------x--------K------------x--x-------------Kxxx------TT--xx-------x-xx-----x--t--x-------x--t---TT--x------xTT-------x-------K-xxx-----TT--xx-------x--xx-----x-t---x------x--t---TT--x-----x-TT--
xxxxxx------xxxxxxxxxxxxxxxxxxxxxx-g--xxxxxxxxxxxxxx---K-----TT----xxxxxxx-gggxxxxx---t---xxxxxxx---t---TT---xxxxxx-TT--------xxxxxxxxx--K-----TT----xxxxxxx-gggxxxxxx--t---xxxxxxx---t---TT--xxxxxxx-TT--
XXXXX---XXX--XXXXXXXXXXXXXXXXXXXXXXXXXXXXXXXXXXXXXXXXXXXXXXXXXXXXXXXXXXXXXXXXXXXXXXXXXXXXXXXXXXXXXXXXXXXXXXXXXXXXXXXXXXXXXXXXXXXXXXXXXXXXXXXXXXXXXXXXXXXXXXXXXXXXXXXXXXXXXXXXXXXXXXXXXXXXXXXXXXXXXXXXXXXXX
XXXXX---XXX--XXXXXXXXXXXXXXXXXXXXXXXXXXXXXXXXXXXXXXXXXXXXXXXXXXXXXXXXXXXXXXXXXXXXXXXXXXXXXXXXXXXXXXXXXXXXXXXXXXXXXXXXXXXXXXXXXXXXXXXXXXXXXXXXXXXXXXXXXXXXXXXXXXXXXXXXXXXXXXXXXXXXXXXXXXXXXXXXXXXXXXXXXXXXX