----------------------------------------------------------------------------------------------------------------------------------------------------------------------------------------------------------
----------------------------------------------------------------------------------------------------------------------------------------------------------------------------------------------------------
----------------------------------------------------------------------------------------------------------------------------------------------------------------------------------------------------------
----------------------------------------------------------------------------------------------------------------------------------------------------------------------------------------------------------
------------------------------------------------------------------------------------------------------------xxx-------------------------------------------------------------------------------------------
----------------------------------------------------------------------------------------------------------xxx-xx------------------------------------------------------------------------------------------
------------------------------------------------------------------------------------------------xxxxx-----x-----x-----------------------------------------------------------------------------------------
--------xxxx---------------------------------------xxxx----------------------------------------x----xx---x-------x-------------xxx---------------------xxxx-----------------------------------------xxx---
--------x--x---TT---------------------------------x---xx---------------------------------------x------xxx---------xx----------xg--x--------------------x---x---------------------------------------x---x--
----xxxx----x--TT---------------------------------xg#---x----------------------------------xxxx----K---#-----------#x--------x-#---x------------xxx---xg#---x----------------------------------xxxx----Kx-
---xx-#-SS---x-##--------------------------xxxxxxx-##----x------------xxxx----------------xx-#--------##----------##-x-----xx-##----x---------xxx-xxxx-##----x------------xxxx----------------xx-#-------x
--x---#L------x----------xxx--------------x----y#####----x-----------x----x--------xxx---x--##-------###---------###-xx---x--###----xx--------x----y#####----x------------x---x--------xxx---x--##-------#
--x---#-------x---1-----x---x-------------x----######-----xx---------x----#xx-----x---x--x-###------####---------###--x---x--###------x------x-----######-----xxx--------x----#xx-----x---x--x-###------##
xxx-kk#--------xxx1xxxxx-----xxxxxxxxxxxxx----#######------Xxxxxxxxxx-----#-xxxxxxx---xxxx####-----#####-------#####---xxx-#####------xxxxxxx-----#######------Xxxxxxxxxx-----#--xxxxxx---xxx-####-----###
XXXXXXXXXXX---XXXX#XXXX----XXXXXXXXXXXXXX---XXXXXXXXX------XXXXXXXXXX---XXXXXXXXXXXXX---XXXXXXXXXXXXXXXXXXXXXXXXXXXXXXXXXXXXXXXXXXXXXXXXXXXXX---XXXXXXXXX------XXXXXXXXXX---XXXXXXXXXXXXX---XXXXXXXXXXXXXX
XXXXXXXXXXX---XXXXXXXXX----XXXXXXXXXXXXXX---XXXXXXXXX-------XXXXXXXXX---XXXXXXXXXXXXX---XXXXXXXXXXXXXXXXXXXXXXXXXXXXXXXXXXXXXXXXXXXXXXXXXXXXX---XXXXXXXXX-------XXXXXXXXX---XXXXXXXXXXXXX---XXXXXXXXXXXXXX